111111111111
10C1000000C1
1000011C1101
111101111101
1P0001E00001
111111111111
