111111111111111111111111111111111111111
1000001000100000000C10100000000010000C1
101110101011101111111010111111101110111
10001C1C1000001010000000001000001000001
101011111011111010111011111110101110111
101000001000101000100000101000100010001
101011101011101111101011101111101111101
101010000000001000001000001010001000101
111011101011101110111111101010111110101
1C1010001010000000000010001010000000C01
101110111111111110111010101011111110101
10000010001000100010101E101010100000101
111111111011101010101011111010101111101
100000001000000010001010000000000010101
101111111011111110101111111011111110111
100000101P00000000100010100010000010101
111111111111111111111111111111111111111