111111111111111111111111111111
1000C000000000100000001C000001
100111111000001011110011111101
10000000000000101C010010000001
1000111111111C1011010010000001
100000000000P110E1010000000001
100001111000001111010000000001
1000011C1000000000000000000001
10000C111000001000000000000001
100000000000001000000000C00001
111111111111111111111111111111