1111111111111
1E00C0000C001
1011110000001
1010001111001
10100000P1001
1111111111111